1111111111111111111111111111
1PP000000000000000000000C001
1C00000000000000000000000001
1000000000000000000000000001
1000000000000000000000000001
1000000000000000000000000001
10000000000000X0000000000001
1000000000000000000000000C01
1000000000000000000000000001
1000000000000000000000000001
1000000000000000000000000001
1000000C00000000000000000EE1
1111111111111111111111111111