111111111111111111111111111
1CPEXC011111111111111111111
100000011111111111111111111
111111111111111111111111111
100000011111111111111111111
111111111111111111111111111
100000011111111111111111111
111111111111111111111111111
100000011111111111111111111
111111111111111111111111111
100000011111111111111111111
111111111111111111111111111
100000011111111111111111111
111111111111111111111111111
100000011111111111111111111
111111111111111111111111111
100000011111111111111111111
111111111111111111111111111
100000011111111111111111111
111111111111111111111111111