11111111
1CPEXC01
1000z001
11111111