11111111
1PEXCC01
11000001
11111111