11111111
1CPEXC01
10000001


11111111