1111111111111111111111111111
1000000000000X0000000000C001
1000000000000000000000000001
1000000000000C00000000001111
10000000111110000011110010P1
1000000000000000000000000001
1110000000000CX0000000001111
1X0000X000000000000000011C11
1000000000000111100000111011
1111111000000000000001110011
1000000000000000000001000111
1000000C000000000000000100E1
1111111111111111111111111111